NO ./tex/tex1.png
SO ./tex/tex4.png
WE ./tex/tex2.png
EA ./tex/tex3.png

F 200,220,250
C 130,140,150

11111111111111111111111111
10000000000000000000000001
10111111111101111111111001
10000000000100000000001001
11111111000101111111001001
10000001000001000001001001
10000001000001111101001001
10000001000000000101000001
10000001111111110101111111
10000000000000000100000001
10111111111111110111111101
10000000000000000000000N01
11111111111111111111111111
