NO ./tex/tex1.png
SO ./tex/tex4.png
WE ./tex/tex2.png
EA ./tex/tex3.png

F 122,90,44
C 207,164,99

11111111111111111111111111111111
10000000000000000000000000000001
10111111111101111111111111111001
10000000000100000000000000001001
11111111000101111111111111001001
10000001000001000000000101001001
10000001000001111111110101001001
10000001000000000100000101000001
10000001111111110111110101111111
10000000000000000100000100000001
10111111111111110111110111111101
10000000000000000000000100000001
10000011111111111111111111110001
10000010000000000000000000010001
10000010111111111111111111010001
10000010000000000000000001010001
10000010111111111111111111010001
10000010000000000000000001010001
10000010111111111111111111010001
10000000000000000000000000000001
10000000000000000000000000000N01
11111111111111111111111111111111
