NO ./tex/tex1.png
SO ./tex/tex4.png
WE ./tex/tex2.png
EA ./tex/tex3.png

F 122,90,44
C 207,164,99

11111111111111111111111111
100000000001111100000000001
101111111001000101111111101
100000001001M01010000000001
111110101111011101011111101
100010100000000000010000001
101010111111111111111011101
100010000000M00000000010001
101111011111011111111011101
10000000000D000000000000001
111111111011111111111111111
1000000000000W0000000000001
11111111111111111111111111
