NO ./tex/tex1.png
EA ./tex/tex3.png
SO ./tex/tex4.png
WE ./tex/tex2.png

F 200,220,250
C 130,140,150

11111111111111111111111111
1000000M0000D0000000M00001
11111111111110000000000001
1000000M0000D0000000M00001
11111111111110000000000001
1000000M0000D0000000M00001
11111111111110000000000001
1000000M0000D0000000W00001
11111111111110000000000001
1000000M0000D0000000M00001
11111111111110000000000001
1000000M0000D0000000M00001
11111111111111111111111111