NO ./tex/tex1.png
SO ./tex/tex4.png
WE ./tex/tex2.png
EA ./tex/tex3.png

F 122,90,44
C 207,164,99

11111111111111111111111111
1000000M0000D0000000M00001
11111111111110000000000001
1000000M0000D0000000M00001
11111111111110000000000001
1000000M0000D0000000M00001
11111111111110000000000001
1000000M0000D0000000W00001
11111111111110000000000001
1000000M0000D0000000M00001
11111111111110000000000001
1000000M0000D0000000M00001
11111111111111111111111111