NO ./tex/BRICK_1A.png
SO ./tex/BRICK_1B.png
WE ./tex/BRICK_4D.png
EA ./tex/BRICK_2B.png

F 200,220,250
C 130,140,150

11111111111111111111111111
100000000000D0000000000001
11111111111110000000000001
100000000000D0000000000001
11111111111110000000000001
100000000000D0000000000001
11111111111110000000000001
100000000000D0000000W00001
11111111111110000000000001
100000000000D0000000000001
11111111111110000000000001
100000000000D0000000000001
11111111111111111111111111