NO ./tex/tex1.png
SO ./tex/tex2.png
WE ./tex/tex3.png
EA ./tex/tex4.png

F 20,22,25
C 13,14,15

111111111111
1         11               
1          1
11111111111
10W00000001
111111111111
11         1
111111111111
