NO ./tex/tex1.png
SO ./tex/tex2.png
WE ./tex/tex3.png
EA ./tex/tex4.png

F 20,22,25
C 13,14,15

111111111111
100000000001               
111111111111
10W000000001
111111111111
1          1
111111111111
