NO ./tex/wall_1.png
SO ./tex/wall_2.png
WE ./tex/wall_3.png
EA ./tex/wall_4.png

F 20,22,25
C 13,14,15

111111111
101000001
10000001
11100000111111111111111111111111111111111111111111111111111111111111111111111111111111111111111111111111111111111111111111111111111111
10000N0000000000000000000000000000000000000000000000000000000000000000000000000000000000000000000000000000000000000000000000000000001
1111111111111111111111111111111111111111111111111111111111111111111111111111111111111111111111111111111111111111111111111111111111111
10011001
100000001
111111111
