NO ./tex/tex1.png
SO ./tex/tex2.png
WE ./tex/tex3.png
EA ./tex/tex4.png

F 20,22,25
C 13,14,15

111111111111111111111     111111111111111111111     111111111111111111111
100000000000000000001     100000000000000000001     100000000000000000001
100000000000000000001     100000000000000000001     100000000000000000001
100000000000000000001     100000000000000000001     100000000000000000001
1000000N000000000001      10000000000000000011       1000000000000000001
100000000000000000001     100000000000000000001     100000000000000000001
101111111111111111101     101111111111111111101     101111111111111111101
100000000000000000001     100000000000000000001     100000000000000000001
100000000000000000001     100000000000000000001     100000000000000000001
100000000000000000001     100000000000000000001     100000000000000000001
100000000000000000001     100000000000000000001     100000000000000000001
111111111111111111111     111111111111111111111     111111111111111111111