NO ./tex/tex1.png
SO ./tex/tex2.png
WE ./tex/tex3.png
EA ./tex/tex4.png

F 20,22,25
C 13,14,15

11111111111111111111111111
10000000000000000000000001
11111111111110000000000001
10000000000000000000000001
11111111111110000000000001
10000000000000000000000001
11111111111110000000000001
100000S0000000000000000001
11111111111110000000000001
10000000000000000000000001
11111111111110000000000001
10000000000000000000000001
11111111111111111111111111
