NO ./tex/BRICK_1A.png
SO ./tex/BRICK_1B.png
WE ./tex/BRICK_4D.png
EA ./tex/BRICK_2B.png

F 20,22,25
C 13,14,15

111111111
100000001
100000001
1000000011111111111111111111111111111111111111111111111111111111111111111111111111111111111111111111111111111111111111111111111111111
10000N00D0000000000000000000000000000000000000000000000000000000000000000000000000000000000000000000000000000000000000000000000000001
11111D1111111111111111111111111111111111111111111111111111111111111111111111111111111111111111111111111111111111111111111111111111111
100000001
100000001
111111111
